00000293
00500313
00530433
00128293
06502223
00628463
ff5ff0ef
06402383